NotRecorded	NotRecorded
DescriptionMissing	DescriptionMissing
HOMECAREIVTHERAPY	HOMECAREIVTHERAPY
AGAINSTMEDICALADVICEWITHFOLLOWUP	AGAINSTMEDICALADVICEWITHFOLLOWUP
ADMITASINPATIENTTHISHOSP	ADMITASINPATIENTTHISHOSP
DISCHARGETOOTHERFACILITYPERLEGAL	DISCHARGETOOTHERFACILITYPERLEGAL
EXPIRED	EXPIRED
HOMESELFCARE	HOMESELFCARE
TOFEDERALHOSPITAL	TOFEDERALHOSPITAL
STILLAPATIENT	STILLAPATIENT
INTERMEDIATECARE	INTERMEDIATECARE
INSURANCECARRIERCHANGE	INSURANCECARRIERCHANGE
HOSPICEHOME	HOSPICEHOME
INTERNALTRANSFERPERLEGALGUIDELINES	INTERNALTRANSFERPERLEGALGUIDELINES
EXPIREDUNKNOWNPLACE	EXPIREDUNKNOWNPLACE
RETURNTRANSFER	RETURNTRANSFER
OTHERINSTFOROUTPATIENTSERVICES	OTHERINSTFOROUTPATIENTSERVICES
TOMCDCERTNOTCARE	TOMCDCERTNOTCARE
EXPIREDATOTHERFACILITY	EXPIREDATOTHERFACILITY
DISCHARGEDFOROTHERREASONS	DISCHARGEDFOROTHERREASONS
DISCHARGETOPSYCHIATRICFACILITY	DISCHARGETOPSYCHIATRICFACILITY
SAMEINSTFOROUTPATIENTSERVICES	SAMEINSTFOROUTPATIENTSERVICES
DISCHARGEFOROTHERREASONWITHFOLLOWUP	DISCHARGEFOROTHERREASONWITHFOLLOWUP
LONGTERMCAREHOSPITAL	LONGTERMCAREHOSPITAL
HOSPICEMEDICALFACILITY	HOSPICEMEDICALFACILITY
XFERPSYREHAB	XFERPSYREHAB
EXPIREDATHOME	EXPIREDATHOME
XFERTOPSYCHHOSP	XFERTOPSYCHHOSP
REGULARDISCHARGEWITHFOLLOWUP	REGULARDISCHARGEWITHFOLLOWUP
AGAINSTMEDICALADVICE	AGAINSTMEDICALADVICE
SHORTTERMHOSPITAL	SHORTTERMHOSPITAL
SKILLEDNURSINGCARE	SKILLEDNURSINGCARE
ANOTHERTYPEOFINSTITUTION	ANOTHERTYPEOFINSTITUTION
OTHERREHABFACILITY	OTHERREHABFACILITY
HOMEHEALTHSERVICE	HOMEHEALTHSERVICE
INPATIENT	INPATIENT
MCRAPPRVDSWINGBED	MCRAPPRVDSWINGBED
DSCHXFERTOOTHER	DSCHXFERTOOTHER
CRITICALACCESSHOSP	CRITICALACCESSHOSP
TOCOURTLAWENFORCE	TOCOURTLAWENFORCE
AGAINSTMEDICALADVICE	AGAINSTMEDICALADVICE
HOMEWITHHOMEHEALTHCARE	HOMEWITHHOMEHEALTHCARE
