Portuguese	Portuguese
Danish	Danish
Tagalog	Tagalog
Polish	Polish
Gujarati	Gujarati
Russian	Russian
Telugu	Telugu
HaitianCreole	HaitianCreole
Cantonese	Cantonese
Dutch	Dutch
German	German
Tigrinya	Tigrinya
Burmese	Burmese
Other	Other
Laotian	Laotian
Turkish	Turkish
Japanese	Japanese
Somali	Somali
Ethiopian	Ethiopian
Yoruba	Yoruba
SignLanguage	SignLanguage
Thai	Thai
Vietnamese	Vietnamese
Amharic	Amharic
Krio	Krio
Malayalam	Malayalam
NotRecorded	NotRecorded
Chinese	Chinese
Romanian	Romanian
Urdu	Urdu
Greek	Greek
Serbian	Serbian
Indonesian	Indonesian
Farsi	Farsi
Spanish	Spanish
Nepali	Nepali
Bosnian	Bosnian
Croatian	Croatian
DescriptionMissing	DescriptionMissing
English	English
Arabic	Arabic
Korean	Korean
French	French
Hebrew	Hebrew
Italian	Italian
Bengali	Bengali
Akan	Akan
Chuukese	Chuukese
Czech	Czech
Hindi	Hindi
Unknown	Unknown
Cambodian	Cambodian
Oromo	Oromo
Armenian	Armenian
Mandarin	Mandarin
Taiwanese	Taiwanese
Punjabi	Punjabi
Neapolitan	Neapolitan
Albanian	Albanian
Bulgarian	Bulgarian
Filipino	Filipino
