NotRecorded	NotRecorded
DescriptionMissing	DescriptionMissing
VIPRECURRING	VIPRECURRING
IPCANCEL	IPCANCEL
INSTITUTIONAL	INSTITUTIONAL
MEDICALRECORDS	MEDICALRECORDS
DAYREHAB	DAYREHAB
INFUSIONSINGLEVISIT	INFUSIONSINGLEVISIT
SINGLEVISITOP	SINGLEVISITOP
TECVISIT	TECVISIT
AMBULATORYSURGERY	AMBULATORYSURGERY
LONGTERMCARE	LONGTERMCARE
NotRecorded	NotRecorded
OBSERVATION	OBSERVATION
INPATIENT	INPATIENT
REHABRECURRING	REHABRECURRING
PSYCHPARTHOSP	PSYCHPARTHOSP
ERTEMP	ERTEMP
TRANSPLANTRECURRING	TRANSPLANTRECURRING
INSTITUTIONALBODY	INSTITUTIONALBODY
HLAQC	HLAQC
PREADMITIN	PREADMITIN
NONPTMISCELLANEOUS	NONPTMISCELLANEOUS
RECONSTRUCTEDPT	RECONSTRUCTEDPT
INFUSIONRECURRING	INFUSIONRECURRING
EMERGENCY	EMERGENCY
UNIDENTIFIEDACCT	UNIDENTIFIEDACCT
CLINICRECURRING	CLINICRECURRING
RECURRINGOP	RECURRINGOP
NEWBORN	NEWBORN
GRANT	GRANT
HISTORY	HISTORY
SPECIMEN	SPECIMEN
TREATRMOP	TREATRMOP
BLOODDONATION	BLOODDONATION
GRANT	GRANT
GRANT	GRANT
HOSPICE	HOSPICE
